[
  {
    "type": "mapgen",
    "method": "json",
    "om_terrain": [ "garage_gas_2" ],
    "//": "Variation with military spawns and a vehicle.  Most often a Patton, sometimes not fully restored to battle-ready condition.",
    "weight": 25,
    "object": {
      "fill_ter": "t_thconc_floor",
      "rows": [
        "____________________`___",
        "________________________",
        "________________________",
        "________________________",
        "________________________",
        "ssssssssss__________s___",
        "sssssssllse________sss__",
        "www-www-|--%%%%%%%%---==",
        "rrr rrrr| e             ",
        "        [           I   ",
        " cc     [               ",
        "     cc |               ",
        "     6  |r          z   ",
        "     c  |r          I   ",
        "     c r|r              ",
        "rrr  c r|r              ",
        "rrr  |+-|               ",
        "     |  +           I   ",
        "     | z|-www-+-|       ",
        "[[[[[| z| kkk  P|rrcccrr",
        "rrrrr| z|  h    |--www--",
        "     +  |    ooo|4......",
        "--------|-------|.......",
        "........................"
      ],
      "terrain": {
        "+": "t_door_c",
        "-": "t_wall_w",
        "|": "t_wall_w",
        ".": "t_region_groundcover_urban",
        " ": "t_thconc_floor",
        "=": "t_door_metal_locked",
        "%": "t_floor",
        "6": "t_console_broken",
        "I": "t_column",
        "[": "t_door_glass_c",
        "_": "t_pavement",
        "`": "t_pavement",
        "e": "t_gates_mech_control",
        "l": "t_sidewalk",
        "s": "t_sidewalk",
        "D": "t_sidewalk",
        "4": "t_gutter_downspout",
        "w": "t_window"
      },
      "furniture": {
        "`": "f_street_light",
        "P": "f_indoor_plant",
        "c": "f_counter",
        "h": "f_chair",
        "k": "f_desk",
        "l": "f_vending_c",
        "o": "f_bookcase",
        "r": "f_rack",
        "z": "f_crate_c"
      },
      "place_vendingmachines": [ { "item_group": "vending_food", "x": 7, "y": 6 }, { "item_group": "vending_drink", "x": 8, "y": 6 } ],
      "place_loot": [
        { "group": "alcohol", "x": [ 0, 4 ], "y": 20, "chance": 75, "repeat": [ 1, 2 ] },
        { "group": "snacks", "x": [ 0, 2 ], "y": 8, "chance": 80, "repeat": [ 2, 8 ] },
        { "group": "mechanics", "x": [ 4, 7 ], "y": 8, "chance": 85, "repeat": [ 1, 2 ] },
        { "group": "snacks", "x": [ 0, 2 ], "y": [ 15, 16 ], "chance": 80, "repeat": [ 2, 8 ] },
        { "group": "snacks", "x": 7, "y": [ 18, 20 ], "chance": 80, "repeat": [ 2, 8 ] },
        { "group": "smoke_shop", "x": 7, "y": [ 14, 15 ], "chance": 70, "repeat": [ 1, 2 ] },
        { "group": "office", "x": [ 10, 12 ], "y": 19, "chance": 75, "repeat": [ 1, 2 ] },
        { "group": "manuals", "x": [ 13, 15 ], "y": 21, "chance": 50, "repeat": [ 1, 2 ] },
        { "group": "mechanics", "x": 9, "y": [ 12, 15 ], "chance": 85, "repeat": [ 1, 2 ] },
        { "group": "mechanics", "x": [ 17, 23 ], "y": 19, "chance": 85, "repeat": [ 1, 3 ] },
        { "group": "fuel_barrel_diesel_only", "x": 20, "y": 10, "chance": 50 },
        { "group": "m60_patton_ammo_rack", "x": 20, "y": 12, "chance": 100 }
      ],
      "place_monsters": [ { "monster": "GROUP_ZOMBIE", "x": [ 0, 23 ], "y": [ 0, 21 ], "chance": 5 } ],
      "place_monster": [
        { "group": "GROUP_MIL_WEAK", "x": [ 0, 23 ], "y": [ 0, 21 ], "chance": 50 },
        { "group": "GROUP_MIL_WEAK", "x": [ 0, 23 ], "y": [ 0, 21 ], "chance": 50 },
        { "group": "GROUP_MIL_WEAK", "x": [ 0, 23 ], "y": [ 0, 21 ], "chance": 50 }
      ],
      "place_vehicles": [ { "vehicle": "tankmod_garage_restoration", "x": 14, "y": 8, "chance": 90, "rotation": 270 } ]
    }
  },
  {
    "type": "mapgen",
    "method": "json",
    "om_terrain": [ "s_garage" ],
    "weight": 100,
    "object": {
      "fill_ter": "t_thconc_floor",
      "rows": [
        "     EEEEEEE  EEEEEEE  '",
        "     EEEEEEE  EEEEEEE   ",
        "     EEEEEEE  EEEEEEE   ",
        "     EEEEEEE  EEEEEEE   ",
        "    eEEEEEEE eEEEEEEEEEE",
        " ----=======--_______--E",
        " |S.eM#MMM#M.eM#MMM#M.|E",
        " |S..M#MMM#M..M#MMM#M.|E",
        " |c..M#MMM#M..M#MMM#M.|E",
        " |c..M#MMM#M..M#MMM#M.|E",
        " |c..M#MMM#M..M#MMM#M.|E",
        " |c..M#MMM#M..M#MMM#M.|E",
        " |c..MMMMMMMMMMMMMMMM.|E",
        " |....................|E",
        " |---l...........HHHHH|E",
        " |ts|c..........CHLLLL|E",
        " |-+|p...........Hbbbb|E",
        "4|...............$....+E",
        " |^W|............Hhbbb|E",
        " |xx|cccccSScccccH6LLL|E",
        " |----::::--::::------|E",
        "                  EU<UEE",
        "                  EUEEEE",
        "                        "
      ],
      "terrain": {
        " ": [ [ "t_region_groundcover_urban", 10 ], "t_region_shrub" ],
        "'": "t_dirt",
        "_": "t_pavement",
        "E": "t_pavement",
        "U": "t_pavement",
        "$": "t_door_glass_c",
        "+": "t_door_c",
        "-": "t_brick_wall",
        ".": "t_thconc_floor",
        ":": "t_window",
        "=": "t_door_metal_locked",
        "6": "t_console_broken",
        "A": "t_m_frame",
        "C": "t_thconc_floor",
        "H": "t_wall_glass",
        "e": "t_gates_mech_control",
        "|": "t_brick_wall",
        "W": "t_chainfence",
        "^": "t_chaingate_c",
        "M": "t_metal_floor",
        "#": "t_grate",
        "4": "t_gutter_downspout",
        "<": "t_ladder_up"
      },
      "furniture": {
        "'": "f_street_light",
        "A": "f_air_conditioner",
        "L": "f_locker",
        "b": "f_bench",
        "c": "f_counter",
        "C": "f_crate_c",
        "s": "f_sink",
        "S": "f_utility_shelf",
        "p": "f_hydraulic_press",
        "l": "f_heavy_lathe",
        "t": "f_toilet",
        "x": "f_utility_shelf",
        "h": "f_chair",
        "U": [ "f_dumpster", "f_recycle_bin" ]
      },
      "items": {
        "L": { "item": "clothing_work_set", "chance": 55 },
        "c": { "item": "mechanics", "chance": 60 },
        "S": { "item": "mechanics", "chance": 80, "repeat": [ 1, 6 ] },
        "x": { "item": "SUS_welding_gear", "chance": 80, "repeat": [ 1, 2 ] }
      },
      "place_loot": [
        { "group": "fuel_barrel_diesel_only", "x": 16, "y": 14, "chance": 50 },
        { "group": "m60_patton_ammo_rack", "x": 16, "y": 15, "chance": 100 }
      ],
      "place_vehicles": [ { "vehicle": "tankmod_garage_restoration", "x": 17, "y": [ 5, 6 ], "chance": 90, "rotation": 270 } ],
      "place_monster": [
        { "group": "GROUP_MIL_WEAK", "x": [ 5, 20 ], "y": [ 7, 15 ], "chance": 50 },
        { "group": "GROUP_MIL_WEAK", "x": [ 5, 20 ], "y": [ 7, 15 ], "chance": 50 },
        { "group": "GROUP_MIL_WEAK", "x": [ 5, 20 ], "y": [ 7, 15 ], "chance": 50 }
      ]
    }
  },
  {
    "type": "mapgen",
    "method": "json",
    "om_terrain": [ "s_garage_1" ],
    "weight": 100,
    "object": {
      "fill_ter": "t_floor",
      "rows": [
        "  ~~~~~~~      ~~~~~~~ '",
        "   ~~~~~~~    *~~~~~~~  ",
        "   ~~~~~~~     ~~~~~~~  ",
        "   ~~~~~~~ *  ~~~~~~~  *",
        "  * ~~~~~~~   ~~~~~~~   ",
        " WWW~~~~~~~WWW~~~~~~~WW ",
        " Wz ~~~~~~~   ~~~~~~~ W ",
        " W* ~~~~~~~   ~~~~~~~ W ",
        " W  z~~~~~~~  ~~~~~~~ W ",
        " W z ~~~~~~~  ~~~~~~~ W ",
        " W  *~~~~~~~  ~~~~~~~ W ",
        " W   ~~~~~~~ ~~~~~~~  W ",
        " W J  ~~~~~~~~~~~~~~ *W ",
        " ^______~~~~~~~~~~~XzzW ",
        " wwwwww_~~~~~~~~~w6dwww ",
        " wxxxPw_~~~~~~~~~wdhLLw ",
        " wSx..w_~~~~~~~~_wd..Lw ",
        " wS..xD_~~~~~~~~_+....+ ",
        " wS.x.w_~~~~~~~~_ww+www ",
        " wccccw4________4ws..tw ",
        " wwwwwwUUUUUUUUUUwwwwww ",
        "                        ",
        "                        ",
        "                        "
      ],
      "terrain": {
        " ": "t_region_groundcover",
        "~": [ "t_region_groundcover_barren", [ "t_pavement", 6 ] ],
        "_": [ "t_region_groundcover_barren", [ "t_sidewalk", 6 ] ],
        "*": [ [ "t_region_tree_shade", 3 ], "t_region_shrub" ],
        "'": "t_dirt",
        "J": "t_water_pump",
        "D": "t_door_locked",
        "+": "t_door_c",
        "w": "t_wall_log",
        "U": "t_brick_wall",
        ".": "t_floor",
        ":": "t_window",
        "W": "t_chainfence",
        "^": "t_chaingate_c",
        "X": [ "t_region_groundcover_barren", [ "t_sidewalk", 6 ] ],
        "z": "t_region_groundcover_barren",
        "4": "t_gutter_downspout",
        "6": "t_console_broken"
      },
      "furniture": {
        "'": "f_street_light",
        "L": "f_locker",
        "c": "f_counter",
        "s": "f_sink",
        "S": "f_utility_shelf",
        "t": "f_toilet",
        "X": "f_crate_c",
        "x": "f_crate_c",
        "h": "f_chair",
        "P": "f_hydraulic_press",
        "d": "f_desk",
        "z": [ "f_wreckage", "f_toilet", "f_dumpster", "f_sink" ]
      },
      "items": {
        "L": { "item": "clothing_work_set", "chance": 55 },
        "c": { "item": "mechanics", "chance": 60 },
        "S": { "item": "mechanics", "chance": 80, "repeat": [ 1, 6 ] },
        "x": { "item": "mechanics", "chance": 80, "repeat": [ 1, 3 ] }
      },
      "place_loot": [
        { "group": "fuel_barrel_diesel_only", "x": 18, "y": 13, "chance": 50 },
        { "group": "m60_patton_ammo_rack", "x": 19, "y": 13, "chance": 100 }
      ],
      "place_monster": [
        { "group": "GROUP_MIL_WEAK", "x": [ 0, 23 ], "y": [ 0, 19 ], "chance": 50 },
        { "group": "GROUP_MIL_WEAK", "x": [ 0, 23 ], "y": [ 0, 19 ], "chance": 50 },
        { "group": "GROUP_MIL_WEAK", "x": [ 0, 23 ], "y": [ 0, 19 ], "chance": 50 }
      ],
      "place_vehicles": [ { "vehicle": "tankmod_garage_restoration", "x": [ 11, 12 ], "y": [ 11, 12 ], "chance": 90, "rotation": 270 } ]
    }
  },
  {
    "type": "mapgen",
    "method": "json",
    "om_terrain": [ "s_garage_2" ],
    "weight": 100,
    "object": {
      "fill_ter": "t_thconc_floor",
      "rows": [
        "   EEEEEEEE     XXX    '",
        "   EEEEEEEE     XXX     ",
        "   EEEEEEEE     XXX     ",
        "   EEEEEEEE     XXX     ",
        "  eEEEEEEEEXXXXXXXXXXXXX",
        " --________----HHOHH---X",
        " |e.M#MM#M..|y.......y|X",
        " |..M#MM#M..|b........|X",
        " :..M#MM#M..:b..|-ddd-|X",
        " :..M#MM#M..:b..|f.h.y|X",
        " A..M#MM#M..:b..|--.--|X",
        " |..M#MM#M..+...+...hd|X",
        " |..MMMMMM..|-+-|f6ddd|X",
        " |..........|&.s|-----|X",
        " |---....---|---|LLLLL|X",
        " |..............|bbbbb|X",
        " |WWWW..WWWW|...+.....|X",
        " |c........c|-------+-|X",
        " |c.xx..xx.p|xx.+T|<..OX",
        " |l.xx..xx.c|x..-|----|X",
        " |w.........O..xx|4UUXXX",
        " |ScccccccwS|----|UXXXXX",
        " |----------|WWWWWWWWWWW",
        "                        "
      ],
      "terrain": {
        " ": "t_region_groundcover_urban",
        "'": "t_dirt",
        "_": "t_floor",
        "E": "t_pavement",
        "X": "t_sidewalk",
        "U": "t_sidewalk",
        "$": "t_door_glass_c",
        "+": "t_door_c",
        "O": "t_door_locked",
        "-": "t_wall_b",
        ".": "t_thconc_floor",
        ":": "t_window",
        "=": "t_door_metal_locked",
        "A": "t_m_frame",
        "H": "t_wall_glass",
        "e": "t_gates_mech_control",
        "|": "t_wall_b",
        "W": "t_chainfence_h",
        "^": "t_chaingate_c",
        "M": "t_metal_floor",
        "#": "t_grate",
        "4": "t_gutter_downspout",
        "6": "t_console_broken",
        "<": "t_stairs_up"
      },
      "toilets": { "&": {  } },
      "furniture": {
        "'": "f_street_light",
        "A": "f_air_conditioner",
        "L": "f_locker",
        "T": "f_rack",
        "b": "f_bench",
        "d": "f_desk",
        "c": "f_counter",
        "p": "f_hydraulic_press",
        "l": "f_heavy_lathe",
        "S": "f_utility_shelf",
        "s": "f_sink",
        "t": "f_toilet",
        "w": "f_utility_shelf",
        "x": "f_crate_c",
        "f": "f_filing_cabinet",
        "h": "f_chair",
        "U": [ "f_dumpster", "f_recycle_bin" ],
        "y": [ "f_indoor_plant", "f_indoor_plant_y" ]
      },
      "items": {
        "L": { "item": "clothing_work_set", "chance": 55 },
        "c": { "item": "mechanics", "chance": 60 },
        "S": { "item": "mechanics", "chance": 80, "repeat": [ 1, 6 ] },
        "x": { "item": "mechanics", "chance": 80, "repeat": [ 1, 6 ] },
        "w": { "item": "SUS_welding_gear", "chance": 80, "repeat": [ 1, 2 ] },
        "f": { "item": "office", "chance": 70, "repeat": [ 1, 6 ] },
        "d": { "item": "office", "chance": 70, "repeat": [ 1, 6 ] },
        "T": { "item": "cleaning", "chance": 70, "repeat": [ 1, 6 ] }
      },
      "place_monster": [
        { "group": "GROUP_MIL_WEAK", "x": [ 0, 23 ], "y": [ 0, 19 ], "chance": 50 },
        { "group": "GROUP_MIL_WEAK", "x": [ 0, 23 ], "y": [ 0, 19 ], "chance": 50 },
        { "group": "GROUP_MIL_WEAK", "x": [ 0, 23 ], "y": [ 0, 19 ], "chance": 50 }
      ],
      "place_vehicles": [ { "vehicle": "tankmod_garage_restoration", "x": 6, "y": [ 4, 5 ], "chance": 90, "rotation": 270 } ]
    }
  },
  {
    "type": "mapgen",
    "method": "json",
    "om_terrain": [ "bunker" ],
    "weight": 500,
    "object": {
      "fill_ter": "t_metal_floor",
      "rows": [
        "   /III/++++++++/III/   ",
        "   /lddI________Iddl/   ",
        "|||/.h?I________I?h./|||",
        "|  /*///________///*/  |",
        "|       ________       |",
        "| yyyyyy________yyyyyy |",
        "| _S_________S________ |",
        "| _S_________S________ |",
        "| ____________________ |",
        "| ____________________ |",
        "| ____________________ |",
        "| _S_________S________ |",
        "| Csyyyy_____S__yyyyyy |",
        "|                      |",
        "|      MMM6  MMMM      |",
        "|      MMMMDDMMMM      |",
        "|      MM,,,,,,MM      |",
        "|      MMMM,,MMMM      |",
        "|      MM,,,,,,MM      |",
        "|      MMMM,,MMMM      |",
        "|      MM,,,,,,MM      |",
        "|||||||MMMM>>MMMM|||||||",
        "       MMMMMMMMMM       ",
        "       MMMMMMMMMM       "
      ],
      "terrain": {
        " ": "t_region_groundcover_urban",
        "*": "t_door_metal_pickable",
        "+": "t_chaingate_l",
        ".": "t_floor",
        ",": "t_metal_floor",
        "_": "t_pavement",
        "/": "t_concrete_wall",
        "?": "t_console_broken",
        "6": "t_card_military",
        ">": "t_stairs_down",
        "d": "t_floor",
        "h": "t_floor",
        "l": "t_floor",
        "C": "t_pavement_y",
        "D": "t_door_metal_locked",
        "I": "t_ballistic_glass",
        "M": "t_wall_metal",
        "S": "t_pavement",
        "s": "t_pavement_y",
        "y": "t_pavement_y",
        "|": "t_chainfence"
      },
      "furniture": { "C": "f_crate_o", "S": "f_sandbag_half", "s": "f_sandbag_half", "d": "f_desk", "h": "f_chair", "l": "f_locker" },
      "items": {
        "C": { "item": "m109_ammo_rack", "chance": 100 },
        "d": { "item": "office_mess", "chance": 50, "repeat": 2 },
        "l": { "item": "military_standard_pistols", "chance": 25 }
      },
      "place_monster": [
        { "group": "GROUP_MAYBE_MIL", "x": [ 14, 22 ], "y": [ 4, 13 ], "repeat": 4 },
        { "monster": "mon_turret_medium", "x": 9, "y": 16 },
        { "monster": "mon_turret_medium", "x": 14, "y": 16 },
        { "monster": "mon_turret_medium", "x": 9, "y": 18 },
        { "monster": "mon_turret_medium", "x": 14, "y": 18 },
        { "monster": "mon_turret_medium", "x": 9, "y": 20 },
        { "monster": "mon_turret_medium", "x": 14, "y": 20 }
      ],
      "place_vehicles": [ { "vehicle": "howitzer_m109", "x": 10, "y": 8, "chance": 100, "rotation": 0 } ]
    }
  }
]
